N:sample01
S:23,17
T:100
D:0,0,2,2,0,0,0,0,0,0,0,0,0,0,0,0,0,0,0,0,0,0,0
D:0,0,2,2,0,0,0,0,0,0,0,3,0,0,0,0,0,0,0,0,0,0,0
D:0,0,2,2,0,0,0,0,0,0,0,0,0,0,0,0,0,0,0,0,0,0,0
D:0,0,2,2,0,0,0,0,0,0,0,0,0,0,3,0,0,0,0,0,0,0,0
D:0,0,2,2,0,0,0,0,3,0,0,0,0,0,0,0,0,0,0,0,0,0,0
D:0,0,2,2,0,0,0,0,0,0,0,0,0,0,0,0,0,0,0,0,0,0,0
D:0,0,2,2,0,0,0,0,0,0,0,0,0,3,0,0,0,0,0,2,2,0,0
D:0,0,2,2,0,0,3,0,0,0,0,0,0,0,0,0,0,0,0,2,2,0,0
D:0,0,2,2,0,0,0,0,0,0,0,0,0,0,0,0,0,0,0,2,2,0,0
D:0,0,2,2,0,0,0,0,0,0,0,0,0,0,0,0,3,0,0,2,2,0,0
D:0,0,2,2,0,0,0,0,0,3,0,0,0,0,0,0,0,0,0,2,2,0,0
D:0,0,0,0,0,0,0,0,0,0,0,0,0,0,0,0,0,0,0,2,2,0,0
D:0,0,0,0,0,0,0,0,0,0,0,0,0,0,3,0,0,0,0,2,2,0,0
D:0,0,0,0,0,0,0,0,3,0,0,0,0,0,0,0,0,0,0,2,2,0,0
D:0,0,0,0,0,0,0,0,0,0,0,0,0,0,0,0,0,0,0,2,2,0,0
D:0,0,0,0,0,0,0,0,0,0,0,3,0,0,0,0,0,0,0,2,2,0,0
D:0,0,0,0,0,0,0,0,0,0,0,0,0,0,0,0,0,0,0,2,2,0,0
H:0,0
C:22,16
