N:sample_map01
S:15,17
T:150
D:0,0,0,0,0,0,0,0,2,2,2,0,3,0,0
D:0,0,2,0,0,0,0,0,0,2,0,0,0,3,0
D:0,0,2,0,0,0,0,0,0,0,0,0,0,0,3
D:0,2,2,0,0,0,0,0,0,0,0,2,2,0,0
D:0,0,0,3,0,0,0,0,0,0,0,0,2,0,0
D:0,0,0,2,3,0,0,0,0,0,0,2,2,0,0
D:2,0,0,2,2,3,0,0,0,0,0,0,0,0,0
D:2,0,0,0,2,0,2,2,2,0,0,0,0,0,2
D:2,0,0,0,0,0,2,2,2,0,0,0,0,0,2
D:2,0,0,0,0,0,2,2,2,0,2,0,0,0,2
D:0,0,0,0,0,0,0,0,0,3,2,2,0,0,2
D:0,0,2,2,0,0,0,0,0,0,3,2,0,0,0
D:0,0,2,0,0,0,0,0,0,0,0,3,0,0,0
D:0,0,2,2,0,0,0,0,0,0,0,0,2,2,0
D:3,0,0,0,0,0,0,0,0,0,0,0,2,0,0
D:0,3,0,0,0,2,0,0,0,0,0,0,2,0,0
D:0,0,3,0,2,2,2,0,0,0,0,0,0,0,0
H:0,0
C:14,16