N:sample_map02
S:15,17
T:100
D:0,0,0,0,0,0,0,0,0,0,0,0,0,0,0
D:0,0,0,0,0,0,0,0,0,0,0,0,0,0,0
D:0,0,0,0,0,3,0,0,0,3,0,0,0,0,0
D:0,0,0,3,0,0,3,0,3,0,0,3,0,0,0
D:0,0,0,0,3,0,2,3,2,0,3,0,0,0,0
D:0,0,0,3,0,3,0,0,0,3,0,3,0,0,0
D:0,0,3,0,2,0,3,0,3,0,2,0,3,0,0
D:0,0,0,3,0,3,0,2,0,3,0,3,0,0,0
D:0,0,3,0,2,0,3,0,3,0,2,0,3,0,0
D:0,0,0,3,0,3,0,0,0,3,0,3,0,0,0
D:0,0,0,0,3,2,0,3,0,2,3,0,0,0,0
D:0,0,0,3,0,0,3,2,3,0,0,3,0,0,0
D:0,0,0,0,0,3,0,2,0,3,0,0,0,0,0
D:0,0,0,0,0,0,0,2,0,0,0,0,0,0,0
D:0,0,0,0,0,0,0,2,0,0,0,0,0,0,0
D:0,0,0,0,0,0,0,2,0,0,0,0,0,0,0
D:0,0,0,0,0,0,2,0,2,0,0,0,0,0,0
H:0,16
C:14,16