N:hamamap
S:15,17
T:200
D:0,0,0,0,0,0,0,0,0,0,0,0,0,0,0
D:0,0,0,0,0,3,0,2,0,3,0,0,0,0,0
D:0,0,0,2,0,0,0,2,0,0,0,2,0,0,0
D:0,0,2,3,0,0,0,2,0,0,0,3,2,0,0
D:0,0,0,3,2,3,2,2,2,3,2,3,0,0,0
D:0,0,0,2,0,0,0,0,0,0,0,2,0,3,0
D:0,3,0,3,0,0,0,3,0,0,0,3,0,0,0
D:0,0,0,2,0,0,0,0,0,0,0,2,0,0,0
D:0,2,3,3,0,3,0,3,0,3,0,3,3,2,0
D:0,0,0,2,0,0,0,0,0,0,0,2,0,0,0
D:0,0,0,3,0,0,0,3,0,0,0,3,0,3,0
D:0,3,0,2,0,0,0,0,0,0,0,2,0,0,0
D:0,0,0,3,2,3,2,2,2,3,2,3,0,0,0
D:0,0,2,3,0,0,0,2,0,0,0,3,2,0,0
D:0,0,0,2,0,0,0,2,0,0,0,2,0,0,0
D:0,0,0,0,0,3,0,2,0,3,0,0,0,0,0
D:0,0,0,0,0,0,0,0,0,0,0,0,0,0,0
H:13,15
C:1,1
