N:katomap
S:15,17
T:200
D:3,0,0,0,0,0,0,0,0,0,0,0,0,0,3
D:0,0,0,0,0,0,0,3,0,0,0,0,0,0,0
D:0,0,2,2,2,2,2,0,2,2,2,2,2,0,0
D:0,0,2,3,0,0,0,0,0,0,0,3,2,0,0
D:0,0,2,0,0,0,0,3,0,0,0,0,2,0,0
D:0,0,2,0,0,0,0,3,0,0,0,0,2,0,0
D:0,0,2,0,0,0,0,0,0,0,0,0,2,0,0
D:0,0,2,0,0,0,0,3,0,0,0,0,2,0,0
D:0,3,0,0,3,0,3,3,3,0,3,0,0,3,0
D:0,0,2,0,0,0,0,3,0,0,0,0,2,0,0
D:0,0,2,0,0,0,0,0,0,0,0,0,2,0,0
D:0,0,2,0,0,0,0,3,0,0,0,0,2,0,0
D:0,0,2,0,0,0,0,3,0,0,0,0,2,0,0
D:0,0,2,3,0,0,0,0,0,0,0,3,2,0,0
D:0,0,2,2,2,2,2,0,2,2,2,2,2,0,0
D:0,0,0,0,0,0,0,3,0,0,0,0,0,0,0
D:3,0,0,0,0,0,0,0,0,0,0,0,0,0,3
H:9,6
C:5,10
