N:B2
T:100
S:15,17
D:0,0,0,0,0,0,0,0,0,0,0,0,0,0,0
D:0,0,3,0,3,0,0,0,0,2,0,2,0,0,0
D:0,0,0,0,0,0,0,0,0,0,0,0,0,2,0
D:0,3,0,0,0,0,0,0,0,0,0,0,0,0,0
D:0,0,0,0,0,0,0,3,0,0,0,0,0,2,0
D:0,3,0,0,0,0,0,0,0,0,0,0,0,0,0
D:0,0,0,0,0,0,0,2,0,0,0,0,0,0,0
D:0,0,0,0,0,0,0,0,0,0,0,0,0,0,0
D:0,0,0,3,0,2,0,3,0,2,0,3,0,0,0
D:0,0,0,0,0,0,0,0,0,0,0,0,0,0,0
D:0,0,0,0,0,0,0,2,0,0,0,0,0,0,0
D:0,0,0,0,0,0,0,0,0,0,0,0,0,3,0
D:0,2,0,0,0,0,0,3,0,0,0,0,0,0,0
D:0,0,0,0,0,0,0,0,0,0,0,0,0,3,0
D:0,2,0,0,0,0,0,0,0,0,0,0,0,0,0
D:0,0,0,2,0,2,0,0,0,0,3,0,3,0,0
D:0,0,0,0,0,0,0,0,0,0,0,0,0,0,0
H:4,11
C:10,5