N:sample_map03
S:15,17
T:100
D:0,0,0,0,0,0,0,0,0,0,0,0,0,0,0
D:0,0,0,0,0,0,0,0,0,0,0,0,0,0,0
D:0,0,3,0,3,0,0,0,0,0,3,0,3,0,0
D:0,0,0,3,0,0,0,0,0,0,0,3,0,0,0
D:0,0,0,0,2,0,0,0,0,0,2,0,0,0,0
D:0,0,0,0,0,2,0,0,0,2,0,0,0,0,0
D:0,0,0,0,2,2,2,2,2,2,2,0,0,0,0
D:0,0,0,2,2,0,2,2,2,0,2,2,0,0,0
D:0,0,2,2,2,2,2,2,2,2,2,2,2,0,0
D:0,0,2,0,2,2,2,2,2,2,2,0,2,0,0
D:0,0,2,0,2,3,3,3,3,3,2,0,2,0,0
D:0,0,3,0,0,2,2,3,2,2,0,0,3,0,0
D:0,0,3,0,0,0,0,3,0,0,0,0,3,0,0
D:0,0,3,0,0,0,0,3,0,0,0,0,3,0,0
D:0,0,3,0,0,0,0,3,0,0,0,0,3,0,0
D:0,0,3,0,0,0,0,3,0,0,0,0,3,0,0
D:0,0,0,0,0,0,0,0,0,0,0,0,0,0,0
H:1,6
C:13,6