N:sampleB
S:23,17
T:120
D:2,2,2,2,0,0,0,0,0,0,0,0,0,0,0,0,0,0,0,2,2,2,2
D:2,2,2,2,0,0,0,0,0,0,0,0,0,0,0,0,0,0,0,2,2,2,2
D:2,2,2,2,0,0,2,2,2,2,2,2,2,2,2,2,2,0,0,2,2,2,2
D:2,2,2,2,0,0,2,0,0,0,0,0,0,0,0,3,2,0,0,2,2,2,2
D:2,2,2,2,0,0,2,0,0,0,0,3,0,0,0,0,2,0,0,2,2,2,2
D:2,2,2,2,0,0,0,0,0,0,0,0,0,0,0,0,2,0,0,2,2,2,2
D:2,2,2,2,0,0,3,0,0,0,0,0,0,0,0,0,2,0,0,2,2,2,2
D:2,2,2,2,0,0,3,0,0,0,0,2,0,0,0,0,2,0,0,2,2,2,2
D:2,2,2,2,0,2,3,0,3,0,0,3,0,0,3,0,3,2,0,2,2,2,2
D:2,2,2,2,0,0,2,0,0,0,0,2,0,0,0,0,3,0,0,2,2,2,2
D:2,2,2,2,0,0,2,0,0,0,0,0,0,0,0,0,3,0,0,2,2,2,2
D:2,2,2,2,0,0,2,0,0,0,0,0,0,0,0,0,0,0,0,2,2,2,2
D:2,2,2,2,0,0,2,0,0,0,0,3,0,0,0,0,2,0,0,2,2,2,2
D:2,2,2,2,0,0,2,3,0,0,0,0,0,0,0,0,2,0,0,2,2,2,2
D:2,2,2,2,0,0,2,2,2,2,2,2,2,2,2,2,2,0,0,2,2,2,2
D:2,2,2,2,0,0,0,0,0,0,0,0,0,0,0,0,0,0,0,2,2,2,2
D:2,2,2,2,0,0,0,0,0,0,0,0,0,0,0,0,0,0,0,2,2,2,2
H:16,11
C:6,5
