N:sampleC
S:23,17
T:180
D:2,2,2,2,0,0,0,0,0,0,0,0,0,0,0,0,0,0,0,2,2,2,2
D:2,2,2,2,0,0,0,0,0,0,0,0,0,0,0,0,0,0,0,2,2,2,2
D:2,2,2,2,0,0,3,3,3,3,3,3,3,3,3,3,3,0,0,2,2,2,2
D:2,2,2,2,0,0,0,0,0,0,0,0,0,0,0,0,3,0,0,2,2,2,2
D:2,2,2,2,0,0,0,0,0,0,0,0,0,0,0,3,3,0,0,2,2,2,2
D:2,2,2,2,0,0,0,0,0,0,0,0,0,0,3,3,0,0,0,2,2,2,2
D:2,2,2,2,0,0,0,0,0,0,0,0,0,3,3,0,0,0,0,2,2,2,2
D:2,2,2,2,0,0,0,0,0,0,0,0,3,3,0,0,0,0,0,2,2,2,2
D:2,2,2,2,0,0,0,0,0,0,3,3,3,0,0,0,0,0,0,2,2,2,2
D:2,2,2,2,0,0,0,0,0,3,3,0,0,0,0,0,0,0,0,2,2,2,2
D:2,2,2,2,0,0,0,0,3,3,0,0,0,0,0,0,0,0,0,2,2,2,2
D:2,2,2,2,0,0,0,3,3,0,0,0,0,0,0,0,0,0,0,2,2,2,2
D:2,2,2,2,0,0,3,3,0,0,0,0,0,0,0,0,0,0,0,2,2,2,2
D:2,2,2,2,0,0,3,0,0,0,0,0,0,0,0,0,0,0,0,2,2,2,2
D:2,2,2,2,0,0,3,3,3,3,3,3,3,3,3,3,3,0,0,2,2,2,2
D:2,2,2,2,0,0,0,0,0,0,0,0,0,0,0,0,0,0,0,2,2,2,2
D:2,2,2,2,0,0,0,0,0,0,0,0,0,0,0,0,0,0,0,2,2,2,2
H:16,8
C:6,8
