N:sampleA
S:23,17
T:200
D:2,2,2,2,0,0,0,0,0,0,0,0,0,0,0,0,0,0,0,2,2,2,2
D:2,2,2,2,0,0,0,0,0,0,0,0,0,0,0,0,0,3,0,2,2,2,2
D:2,2,2,2,0,0,3,0,0,0,0,0,0,0,3,0,0,0,0,2,2,2,2
D:2,2,2,2,0,0,2,0,0,0,3,0,0,0,0,0,0,0,0,2,2,2,2
D:2,2,2,2,0,0,0,0,0,0,0,0,2,0,0,0,0,0,0,2,2,2,2
D:2,2,2,2,0,0,0,0,0,0,0,0,0,0,0,0,3,0,0,2,2,2,2
D:2,2,2,2,0,0,3,0,0,3,0,0,3,0,0,0,0,0,0,2,2,2,2
D:2,2,2,2,0,0,0,0,0,0,0,0,0,0,0,0,0,3,0,2,2,2,2
D:2,2,2,2,0,0,0,0,0,0,0,3,0,0,0,0,0,0,0,2,2,2,2
D:2,2,2,2,0,3,0,0,0,0,0,0,0,0,0,0,0,0,0,2,2,2,2
D:2,2,2,2,0,0,0,0,0,0,3,0,0,3,0,0,3,0,0,2,2,2,2
D:2,2,2,2,0,0,3,0,0,0,0,0,0,0,0,0,0,0,0,2,2,2,2
D:2,2,2,2,0,0,0,0,0,0,2,0,0,0,0,0,0,0,0,2,2,2,2
D:2,2,2,2,0,0,0,0,0,0,0,0,3,0,0,0,2,0,0,2,2,2,2
D:2,2,2,2,0,0,0,0,3,0,0,0,0,0,0,0,3,0,0,2,2,2,2
D:2,2,2,2,0,3,0,0,0,0,0,0,0,0,0,0,0,0,0,2,2,2,2
D:2,2,2,2,0,0,0,0,0,0,0,0,0,0,0,0,0,0,0,2,2,2,2
H:13,15
C:9,1
