N:sayuu001
S:23,17
T:200
D:0,0,0,0,0,0,0,0,0,0,0,0,0,0,0,0,0,0,0,0,0,0,0
D:0,0,0,0,0,0,0,0,0,0,0,0,0,0,0,0,0,0,0,0,0,0,0
D:0,3,3,3,0,0,0,0,0,0,0,3,0,0,0,0,0,0,0,3,3,3,0
D:3,0,0,0,3,0,0,0,0,0,0,2,0,0,0,0,0,0,3,0,0,0,3
D:3,0,0,0,0,0,0,0,0,0,0,2,0,0,0,0,0,0,0,0,0,0,3
D:3,0,0,0,3,0,0,0,0,0,0,2,0,0,0,0,0,0,3,0,0,0,3
D:0,3,3,3,0,0,0,0,0,0,0,2,0,0,0,0,0,0,0,3,3,3,0
D:0,0,0,0,0,0,0,0,0,0,0,2,0,0,0,0,0,0,0,0,0,0,0
D:0,0,0,0,0,3,0,0,0,3,0,2,0,3,0,0,0,3,0,0,0,0,0
D:0,0,0,0,0,3,0,0,0,3,0,2,0,3,0,0,0,3,0,0,0,0,0
D:0,0,0,0,0,3,3,3,3,3,0,2,0,3,3,3,3,3,0,0,0,0,0
D:0,0,0,0,0,3,0,0,0,3,0,2,0,3,0,0,0,3,0,0,0,0,0
D:0,0,0,0,0,3,0,0,0,3,0,2,0,3,0,0,0,3,0,0,0,0,0
D:0,0,0,0,0,0,0,0,0,0,0,2,0,0,0,0,0,0,0,0,0,0,0
D:0,0,0,0,0,0,0,0,0,0,0,2,0,0,0,0,0,0,0,0,0,0,0
D:0,0,0,0,0,0,0,0,0,0,0,2,0,0,0,0,0,0,0,0,0,0,0
D:0,0,0,0,0,0,0,0,0,0,0,2,0,0,0,0,0,0,0,0,0,0,0
H:21,7
C:1,7
